11111111711111111111111711111111111111711211111111
14444444414444444144444414444414444144441244444441
14444444484444444144444414444414444144441244444441
14444444414444444744444414444414444144448244444441
14444444414444444144444414444414444144441244444441
92222222232444444144444414444414444144441244222222
14444444412222222922222232222292222322223922244441
14444444414444444144444414444414444144441244444441
14444444414444444144444414444414444744448244444441
74444444414444444144444474444414444144441244444441
14444444414444444144444414444410000100001204444441
10000004484444444144440010000010000100001200000001
10000000014444444100000010000010000100001200000001
14440000010000000100000010000010000100001200000001
14444440010000000100004414444414444144441244444441
14444444410000044144444414444414444144448244444441
14444444414444444144444414444474444144441244444447
14444444484444444144444414444414444144441222444441
14444444414444444144444414444414444144441442411811
11111117111111181111111111111111111111111119114441
14444444414444444144444414444414444144441442444441
74444444414444444144444414444414444144441442444441
14444444414444444144444414444414444144441222444441
14444444414444444144444414444414444144441244444441
11111111114444444111711111111111111111111311111111
14444444414444444844444414444414444144441244444441
14444444411111111144444414444414444144441244444441
14444444414444444144444414444414444144441244444441
14444444414444444144444414444414444144441244444441
11111711111111111111111111111111171111111911171111
