111711111111111111111111111111
144444441444444440041444441441
144444441444444440047444441441
144444441444444440041444441441
111111111117111111111111111441
144444441444444400041444441448
144444448444444400441444441441
144444441444444000441444441111
144444441444444004441444441441
111111111444440004441117111441
144444441444000044441444441441
144444441444000004223222229223
144444441444400004241444441441
144444441444400004241444441441
144444447444444004241444447441
144444441444444004241444441441
111111111111111111311111111111
144444441444414004241444441441
144444441444414004241444441441
144444441444414004241444441441
144444441444414004241444441111
144444441444414004247444441441
144444441444414004241444441441
111718111111711111311181111441
144444441444410044241444441441
322222229222232222241444441441
144444441444410004441444441441
144444441444414004441444441441
144444441444414004441444441441
111111111111111111171111111111
