11111111111111111111111711111111111111711111111118
14444441444444144444444444144444441444444414444441
14444441444444144444444444144444448444444414444441
14444441444444144444444444144444441111111114444441
14444441444444144444444444144444441444444414444441
74444441444444111111111111144444441444444414444441
14444441444444144444444444144444441444444484444441
14444441444444144444444444144444441444444414444441
14444441444444144444444444144444441444444414444441
11111111111711144444444444111171111111111111111111
14444441444444140000000004144444444444444414444441
14444441444444140000000004144444444000444414444441
14444441444444140000000004144440000000044414444447
14444441444444140000000004144440000000044414444441
14444441444444140000000004144440000000044414444441
14444441444444140000000004144444444000444414444441
14444441444444140000000004144444444444444414444441
11111111111111111111111171111111111111117111111111
14444441444444144444444444444144444444444414444441
14444441444444144444444444444144444444444414444441
14444441444444144444444444444144444444444414444441
74444441444444144444444444444144444444444414444441
14444441444444144444444444444144444444444414444441
11811111111171111111811111111111111171111111111811
14444441444444144444444414444444444444444414444441
14444441444444144444444474444444444444444414444441
14444441444444144444444414444444444444444414444441
14444441444444144444444414444444444444444414444441
14444441444444144444444414444444444444444414444441
11111711111111111111111111111111111111111111171111
